XXXXXX
X  X X
XX X X
XP   X
XXXXXX